555555555555555552255555555555555555555655555555555555555555552255555555555555555555655555555555555555555552255555555555555555555655555
555555555555565552255555555556555555555555555555555555555555552255555555555555555555655555555555555555555552255555555555555555555655555
555555555555555552255555555555555555555555555555555555555555552255555555555555555555655555555555555555555552255555555555555555555655555
555556555555555552255555555555555555555555555555555555555555552255555555555555555555655555555555555555555552255555555555555555555655555
555555555555555552255555555555555555555555555555555555555555552255555555555555555555655555555555555555555552255555555555555555555655555
555555555555555552255555555555555555555555555555555555555555552255555555555555555555655555555555555555555552255555555555555555555655555
555555555555555552265555555555555555555555555555555555555555552255555555555555555555655555555555555555555552255555555555555555555655555
555555555555555552255555555555555555555555555555555555555555552255555555555555555555655555555555555555555552255555555555555555555655555
555555555555555552255555555555555555555555555555555555555555552255555555555555555555655555555555555555555552255555555555555555555655555
555555555555555552255555555555555555555555555555555555555555552255555555555555555555655555555555555555555552255555555555555555555655555
555555555555555552255555555555555555555555555555555555555555552255555555555555555555655555555555555555555552255555555555555555555655555
555555555555555552255555555555555555555555555555555555555555552255555555555555555555655555555555555555555552255555555555555555555655555
555555655555555552255555555555555555555555555555555555555555552255555555555555555555655555555555555555555552255555555555555555555655555
222222222222222222222222222222222222222222222222222222222222222222222222222222222222222222222222222222222222222222222222222222222222222
222222222222222222222222222222222222222222222222222222222222222222222222222222222222222222222222222222222222222222222222222222222222222
555555555555555552255555555555555555555555555555555555555555552255555555555555555555655555555555555555555552255555555555555555555655555
555555555555555552255555555555555555555555555555555555555555552255555555555555555555655555555555555555555552255555555555555555555655555
555555555555555552255555555555555555555555555555555555555555552255555555555555555555655555555555555555555552255555555555555555555655555
555555555555555552255555555555555555555555555555555555555555552255555555555555555555655555555555555555555552255555555555555555555655555
555555555555555552255555555555555555555555555555555555555555552255555555555555555555655555555555555555555552255555555555555555555655555
555555555555555552255555555555555555555555555555555555555555552255555555555555555555655555555555555555555552255555555555555555555655555
555555555555555552255555555555555556555555555555555555555555552255555555555555555555655555555555555555555552255555555555555555555655555
555555555555555552255555555555555555555555555555555555555555552255555555555555555555655555555555555555555552255555555555555555555655555
555555556555555552255555555555555555555555555555555555555555552255555555555555555555655555555555555555555552255555555555555555555655555
555555555555555552255555555555555555555555555555555555555555552255555555555555555555655555555555555555555552255555555555555555555655555
555555555555555552255555555555555555555555555555555555555555552255555555555555555555655555555555555555555552255555555555555555555655555
555555555555555552255555555555555555555555555555555555555555552255555555555555555555655555555555555555555552255555555555555555555655555
555555555555555552255555555555555555555555555555555555555555552255555555555555555555655555555555555555555552255555555555555555555655555
555555555555555552255555555555555555555655555555555555555555552255555555555555555555655555555555555555555552255555555555555555555655555
555555555555565552255555555556555555555555555555555555555555552255555555555555555555655555555555555555555552255555555555555555555655555
555555555555555552255555555555555555555555555555555555555555552255555555555555555555655555555555555555555552255555555555555555555655555
555556555555555552255555555555555555555555555555555555555555552255555555555555555555655555555555555555555552255555555555555555555655555
555555555555555552255555555555555555555555555555555555555555552255555555555555555555655555555555555555555552255555555555555555555655555
555555555555555552255555555555555555555555555555555555555555552255555555555555555555655555555555555555555552255555555555555555555655555
555555555555555552265555555555555555555555555555555555555555552255555555555555555555655555555555555555555552255555555555555555555655555
555555555555555552255555555555555555555555555555555555555555552255555555555555555555655555555555555555555552255555555555555555555655555
555555555555555552255555555555555555555555555555555555555555552255555555555555555555655555555555555555555552255555555555555555555655555
555555555555555552255555555555555555555555555555555555555555552255555555555555555555655555555555555555555552255555555555555555555655555
555555555555555552255555555555555555555555555555555555555555552255555555555555555555655555555555555555555552255555555555555555555655555
555555555555555552255555555555555555555555555555555555555555552255555555555555555555655555555555555555555552255555555555555555555655555
555555655555555552255555555555555555555555555555555555555555552255555555555555555555655555555555555555555552255555555555555555555655555
222222222222222222222222222222222222222222222222222222222222222222222222222222222222222222222222222222222222222222222222222222222222222
222222222222222222222222222222222222222222222222222222222222222222222222222222222222222222222222222222222222222222222222222222222222222
555555555555555552255555555555555555555555555555555555555555552255555555555555555555655555555555555555555552255555555555555555555655555
555555555555555552255555555555555555555555555555555555555555552255555555555555555555655555555555555555555552255555555555555555555655555
555555555555555552255555555555555555555555555555555555555555552255555555555555555555655555555555555555555552255555555555555555555655555
555555555555555552255555555555555555555555555555555555555555552255555555555555555555655555555555555555555552255555555555555555555655555
555555555555555552255555555555555555555555555555555555555555552255555555555555555555655555555555555555555552255555555555555555555655555
555555555555555552255555555555555555555555555555555555555555552255555555555555555555655555555555555555555552255555555555555555555655555
555555555555555552255555555555555556555555555555555555555555552255555555555555555555655555555555555555555552255555555555555555555655555
555555555555555552255555555555555555555555555555555555555555552255555555555555555555655555555555555555555552255555555555555555555655555
555555556555555552255555555555555555555555555555555555555555552255555555555555555555655555555555555555555552255555555555555555555655555
555555555555555552255555555555555555555555555555555555555555552255555555555555555555655555555555555555555552255555555555555555555655555
555555555555555552255555555555555555555555555555555555555555552255555555555555555555655555555555555555555552255555555555555555555655555
555555555555555552255555555555555555555555555555555555555555552255555555555555555555655555555555555555555552255555555555555555555655555
555555555555555552255555555555555555555555555555555555555555552255555555555555555555655555555555555555555552255555555555555555555655555
555555555555555552255555555555555555555655555555555555555555552255555555555555555555655555555555555555555552255555555555555555555655555
555555555555565552255555555556555555555555555555555555555555552255555555555555555555655555555555555555555552255555555555555555555655555
555555555555555552255555555555555555555555555555555555555555552255555555555555555555655555555555555555555552255555555555555555555655555
555556555555555552255555555555555555555555555555555555555555552255555555555555555555655555555555555555555552255555555555555555555655555
555555555555555552255555555555555555555555555555555555555555552255555555555555555555655555555555555555555552255555555555555555555655555
555555555555555552255555555555555555555555555555555555555555552255555555555555555555655555555555555555555552255555555555555555555655555
555555555555555552265555555555555555555555555555555555555555552255555555555555555555655555555555555555555552255555555555555555555655555
555555555555555552255555555555555555555555555555555555555555552255555555555555555555655555555555555555555552255555555555555555555655555
555555555555555552255555555555555555555555555555555555555555552255555555555555555555655555555555555555555552255555555555555555555655555
555555555555555552255555555555555555555555555555555555555555552255555555555555555555655555555555555555555552255555555555555555555655555
555555555555555552255555555555555555555555555555555555555555552255555555555555555555655555555555555555555552255555555555555555555655555
555555555555555552255555555555555555555555555555555555555555552255555555555555555555655555555555555555555552255555555555555555555655555
555555655555555552255555555555555555555555555555555555555555552255555555555555555555655555555555555555555552255555555555555555555655555
222222222222222222222222222222222222222222222222222222222222222222222222222222222222222222222222222222222222222222222222222222222222222
222222222222222222222222222222222222222222222222222222222222222222222222222222222222222222222222222222222222222222222222222222222222222
555555555555555552255555555555555555555555555555555555555555552255555555555555555555655555555555555555555552255555555555555555555655555
555555555555555552255555555555555555555555555555555555555555552255555555555555555555655555555555555555555552255555555555555555555655555
555555555555555552255555555555555555555555555555555555555555552255555555555555555555655555555555555555555552255555555555555555555655555
555555555555555552255555555555555555555555555555555555555555552255555555555555555555655555555555555555555552255555555555555555555655555
555555555555555552255555555555555555555555555555555555555555552255555555555555555555655555555555555555555552255555555555555555555655555
555555555555555552255555555555555555555555555555555555555555552255555555555555555555655555555555555555555552255555555555555555555655555
555555555555555552255555555555555556555555555555555555555555552255555555555555555555655555555555555555555552255555555555555555555655555
555555555555555552255555555555555555555555555555555555555555552255555555555555555555655555555555555555555552255555555555555555555655555
555555556555555552255555555555555555555555555555555555555555552255555555555555555555655555555555555555555552255555555555555555555655555
555555555555555552255555555555555555555555555555555555555555552255555555555555555555655555555555555555555552255555555555555555555655555
555555555555555552255555555555555555555555555555555555555555552255555555555555555555655555555555555555555552255555555555555555555655555
555555555555555552255555555555555555555555555555555555555555552255555555555555555555655555555555555555555552255555555555555555555655555
555555555555555552255555555555555555555555555555555555555555552255555555555555555555655555555555555555555552255555555555555555555655555
